**************
*     *      *
* * *   *    *
* * *  *     *
* *  *E*     *
* ** **  **  *
*     * *  * *
*  **   *  * *
* *  *  *    *
* *  *   *   *
*  *  *   *  *
*  *   *   ***
*    *      S*
**************
